level_4,level_3,level_5,level_1,level_0,level_2
level_0
xxxxxxxxxx00xxxxxxxxxx
x....................x
x....................x
x....................x
x..........T.........x
x....................x
x....................x
x....................x
x....................x
0....................0
0....................0
x....................x
x..xxxxx......xxxxx..x
x....................x
x....................x
x....................x
x....................x
x....................x
x....................x
x....................x
x....................x
xxxxxxxxxxxxxxxxxxxxxx
level_1
xxxxxxxxxxxxxxxxxxxxxx
x....................x
x....T...............x
x.......xxxxx........x
x....................x
x....................x
x....................x
x.......x............x
x.......x............x
x.......x............0
x.......x............0
x.......x............x
x.......x............x
x....................x
x....................x
x....T...............x
x....................x
x....................x
x....................x
x....................x
x....................x
xxxxxxxxxxxxxxxxxxxxxx
level_2
xxxxxxxxxxxxxxxxxxxxxx
x....................x
x...............T....x
x........xxxxx.......x
x....................x
x....................x
x....................x
x.............x......x
x.............x......x
0.............x......x
0.............x......x
x.............x......x
x.............x......x
x....................x
x....................x
x..............T.....x
x....................x
x....................x
x....................x
x....................x
x....................x
xxxxxxxxxxxxxxxxxxxxxx
level_3
xxxxxxxxxxxxxxxxxxxxxx
x....................x
x....................x
x....................x
x..........T.........x
x..T..............T..x
x....................x
x....................x
x.......xxxxxx.......x
0....................0
0....................0
x....................x
x..xxxxx......xxxxx..x
x....................x
x....................x
x....................x
x....................x
x....................x
x....................x
x....................x
x....................x
xxxxxxxxxx00xxxxxxxxxx
level_4
xxxxxxxxxxxxxxxxxxxxxx
x....................x
x....T...............x
x.......xxxxx........x
x....................x
x....................x
x....................x
x.......x............x
x.......x............x
x.......x............0
x.......x............0
x.......x............x
x.......x............x
x....................x
x....................x
x....T...............x
x....................x
x....................x
x....................x
x....................x
x....................x
xxxxxxxxxxxxxxxxxxxxxx
level_5
xxxxxxxxxx00xxxxxxxxxx
x....................x
x...............T....x
x........xxxxx.......x
x....................x
x....................x
x....................x
x.............x......x
x.............x......x
0.............x......x
0.............x......x
x.............x......x
x.............x......x
x....................x
x....................x
x..............T.....x
x....................x
x....................x
x....................x
x....................x
x....................x
xxxxxxxxxxxxxxxxxxxxxx.